0001110000013100111101001340411111154031001411110013100000111000
0011110011100100115401001114011111104011113400111133731111111111
0111110001501110010400101110101113101001134001011300040111111111
1111111010334010101040101010101010451010134000101311111011100000
0011111011100010104010111010030110000101114130010150011101111100
0011111011100010104010111010030110300101114134010150011101111100